64 50
7,7,7,7,7,7,7,7,7,7,7,7,7,7,7,7,7,7,7,7,7,7,7,7,7,7,7,7,7,7,7,7,7,7,7,7,7,7,7,7,7,7,7,7,7,7,7,7,7,7,7,7,7,7,7,7,7,7,7,7,7,7,7,7
7,7,7,7,7,7,7,7,7,7,7,7,7,7,7,7,7,7,7,7,7,7,7,7,7,7,7,7,7,7,7,7,7,7,7,7,7,7,7,7,7,7,7,7,7,7,7,7,7,7,7,7,7,7,7,7,7,7,7,7,7,7,7,7
7,7,7,7,7,7,7,7,7,7,7,7,7,7,7,7,7,7,7,7,7,7,7,7,7,7,7,7,7,7,7,7,7,7,7,7,7,7,7,7,7,7,7,7,7,7,7,7,7,7,7,7,7,7,7,7,7,7,7,7,7,7,7,7
7,7,7,7,7,7,7,7,7,7,7,7,7,7,7,7,7,7,7,7,7,7,7,7,7,7,7,7,7,7,7,7,7,7,7,7,7,7,7,7,7,7,7,7,7,7,7,7,7,7,7,7,7,7,7,7,7,7,7,7,7,7,7,7
7,7,7,7,7,7,7,7,7,7,7,7,7,7,7,7,7,7,7,7,7,7,7,7,7,7,7,7,7,7,7,7,7,7,7,7,7,7,7,7,7,7,7,7,7,7,7,7,7,7,7,7,7,7,7,7,7,7,7,7,7,7,7,7
7,7,7,7,7,7,7,7,7,7,7,7,7,7,7,7,7,7,7,7,7,7,7,7,7,7,7,7,7,7,7,7,7,7,7,7,7,7,7,391,392,392,392,392,392,392,392,392,392,392,392,392,392,392,392,392,392,392,392,392,393,7,7,7
7,7,7,7,7,7,7,7,7,7,7,7,7,7,7,7,7,7,7,7,7,7,7,7,7,7,7,7,7,7,7,7,7,7,7,7,7,7,7,421,422,422,422,422,422,422,422,422,422,422,422,422,422,422,422,422,422,422,422,422,423,7,7,7
7,7,7,7,7,274,275,275,275,275,275,275,276,7,7,7,7,7,7,7,7,7,7,7,7,7,7,7,7,7,7,7,7,7,7,7,7,7,7,421,422,422,422,422,422,422,422,422,422,452,422,422,422,422,422,422,422,422,422,422,423,7,7,7
7,7,7,7,7,304,305,305,305,305,305,305,306,7,7,7,7,7,7,7,7,7,7,7,7,7,7,7,7,7,7,7,7,7,7,7,7,7,7,421,422,422,422,422,422,422,422,422,423,76,421,422,422,422,422,422,422,422,422,422,423,7,7,7
7,7,7,7,274,305,305,305,305,305,305,305,305,276,7,7,7,7,7,7,7,7,7,7,7,7,7,7,7,7,7,7,7,7,7,7,7,7,7,421,422,422,422,422,422,422,422,422,422,392,422,422,422,422,422,422,422,422,422,422,423,7,7,7
7,7,7,274,305,305,305,305,305,305,305,305,305,306,7,7,7,7,7,7,7,7,7,7,7,7,7,7,7,7,7,7,7,7,7,7,7,7,7,421,422,422,422,422,422,422,422,422,422,422,422,422,422,422,422,422,422,422,422,422,423,7,7,7
7,7,7,304,305,305,305,305,305,305,305,305,305,306,7,7,7,7,7,7,131,131,131,131,131,131,131,131,131,131,131,131,131,131,131,131,131,131,7,421,422,422,422,422,422,422,422,422,422,422,422,422,422,422,422,422,422,422,422,422,423,7,7,7
7,7,7,304,305,305,305,305,305,305,305,305,305,306,7,7,7,7,7,7,131,277,278,278,278,278,278,278,278,278,278,278,278,278,278,278,279,131,7,421,422,422,422,422,422,371,371,371,422,422,422,422,422,422,422,422,371,371,371,422,423,7,7,7
7,7,7,304,305,305,305,305,305,305,305,305,305,306,7,7,7,7,7,7,131,307,308,308,308,308,308,308,308,308,308,308,308,308,308,308,309,131,7,421,422,422,422,422,422,371,371,371,422,422,422,422,422,422,422,422,371,371,371,422,423,7,7,7
7,7,7,304,305,305,305,305,305,305,305,305,305,306,7,7,7,7,7,7,131,307,308,308,308,308,308,308,308,308,308,308,308,308,308,308,309,131,7,421,422,422,422,422,422,422,422,422,422,422,422,422,422,422,422,422,422,422,422,422,423,7,7,7
7,7,7,304,305,305,305,305,305,305,305,305,305,306,7,7,7,7,7,7,131,307,308,308,339,338,338,338,338,338,338,338,338,337,308,308,309,131,7,451,452,452,452,452,452,452,452,452,452,452,452,452,452,452,452,452,452,452,452,452,453,7,7,7
7,7,7,304,305,305,305,305,305,305,305,305,305,305,276,7,7,7,7,7,131,307,308,308,309,7,7,7,7,7,7,7,7,307,308,308,309,131,7,7,7,7,7,7,7,7,7,7,7,7,7,7,7,7,7,7,7,7,7,7,7,7,7,7
7,7,7,304,305,305,305,305,305,305,305,305,305,305,306,7,7,7,7,7,131,307,308,308,309,7,7,7,125,7,125,7,7,307,308,308,309,131,7,7,7,7,7,7,7,7,7,7,7,7,7,7,7,7,7,7,7,7,7,7,7,7,7,7
7,7,7,304,305,305,305,305,305,305,305,305,305,305,306,7,7,7,7,7,131,307,308,308,309,7,125,7,7,125,125,156,7,307,308,308,309,131,7,7,7,7,7,7,7,7,7,7,7,7,7,7,7,7,7,7,7,7,7,7,7,7,7,7
7,7,7,334,305,305,305,305,305,305,305,305,335,335,336,7,7,7,7,7,131,307,308,308,309,7,7,125,7,7,7,7,7,307,308,308,309,131,7,7,7,7,7,7,7,7,7,7,7,7,7,7,7,7,7,7,7,7,7,7,7,7,7,7
7,7,7,7,334,335,335,335,335,335,335,336,7,7,7,7,7,7,7,7,131,307,308,308,309,7,7,7,7,7,7,125,7,307,308,308,309,131,7,7,7,7,7,7,7,7,7,7,7,7,7,7,7,7,7,7,7,7,7,7,7,7,7,7
7,7,7,7,7,7,7,7,7,7,7,7,7,7,7,7,7,7,7,7,131,307,308,308,309,7,7,7,7,7,7,7,7,307,308,308,309,131,7,7,7,7,7,7,7,7,7,7,7,7,7,7,7,7,7,7,7,7,7,7,7,7,7,7
7,7,7,7,7,7,7,7,7,7,7,7,7,7,7,7,7,7,7,7,131,307,308,308,309,7,125,7,7,7,7,7,7,307,308,308,309,131,7,7,7,7,7,7,7,7,7,7,7,7,7,7,7,7,7,7,7,7,7,7,7,7,7,7
7,7,7,7,7,7,7,7,7,7,7,7,7,7,7,7,7,7,7,7,131,307,308,308,309,7,7,7,7,7,7,7,7,307,308,308,309,131,7,7,7,7,7,7,7,7,7,7,7,7,7,7,7,7,7,7,7,7,7,7,7,7,7,7
7,7,7,7,7,7,7,7,7,7,7,7,7,7,7,7,7,7,7,7,131,307,308,308,309,7,125,7,7,125,7,125,7,307,308,308,309,131,7,7,7,7,131,7,7,7,7,7,7,7,7,7,7,131,7,7,7,7,7,7,7,7,7,7
7,7,7,7,7,7,7,7,7,7,7,7,7,7,7,7,7,7,7,7,131,307,308,308,309,7,7,7,7,7,7,7,7,307,308,308,309,131,7,7,7,7,131,7,7,7,7,7,7,7,7,7,7,131,7,7,7,7,7,7,7,7,7,7
7,7,7,7,7,7,7,7,7,7,7,7,7,7,7,7,7,7,7,7,131,307,308,308,279,278,278,278,278,278,278,278,278,277,308,308,309,131,7,7,7,7,131,7,7,7,7,7,7,7,7,7,7,131,7,7,7,7,7,7,7,7,7,7
7,7,7,7,7,7,7,7,7,7,7,7,7,7,7,7,7,7,7,7,131,307,308,308,308,308,308,308,308,308,308,308,308,308,308,308,309,131,131,131,131,131,131,131,131,131,131,131,131,131,131,131,131,131,131,131,131,131,131,131,131,131,131,131
7,7,7,7,7,7,7,7,7,7,7,7,7,7,7,7,7,7,7,7,131,307,308,308,308,308,308,308,308,308,308,308,308,308,308,308,309,131,131,131,131,131,131,131,131,131,131,131,131,131,131,131,131,131,131,131,131,131,131,131,131,131,131,131
7,7,7,7,7,7,7,7,7,7,7,7,7,7,7,7,7,7,7,7,131,337,338,338,338,338,338,338,338,338,338,338,338,338,338,338,339,131,131,131,131,131,131,131,131,131,131,131,131,131,131,131,131,131,131,131,131,131,131,131,131,131,131,131
7,7,7,7,7,7,7,7,7,7,7,7,7,7,7,7,7,7,7,7,131,131,131,131,131,131,131,131,131,131,131,131,131,131,131,131,131,131,131,131,131,131,131,131,131,131,131,131,131,131,131,131,131,131,131,131,131,131,131,131,131,131,131,131
7,7,7,7,7,7,7,7,7,7,7,7,7,7,7,7,7,7,7,7,221,221,221,221,221,221,221,221,221,221,221,221,221,221,221,221,221,221,221,221,221,221,221,221,221,221,221,221,221,221,221,221,221,221,221,221,221,221,221,221,221,221,221,221
7,7,7,7,7,7,7,7,7,7,7,7,7,7,7,7,7,7,7,7,221,221,221,221,221,221,221,221,221,221,221,221,221,221,221,221,221,221,221,221,221,221,221,221,221,221,221,221,221,221,221,221,221,221,221,221,221,221,221,221,221,221,221,221
7,7,7,7,7,7,7,7,7,7,7,7,7,156,7,7,7,7,7,7,7,7,7,7,7,7,7,7,7,7,7,7,7,7,7,7,7,7,7,7,7,7,7,7,7,7,7,7,7,7,7,7,7,7,7,7,7,7,7,7,7,7,7,7
7,7,7,7,7,7,7,125,7,7,7,7,7,7,7,7,7,12,70,7,7,7,7,7,7,7,7,7,7,7,7,7,7,7,7,7,7,7,7,7,7,7,7,7,7,7,7,7,7,7,7,7,7,7,7,7,7,7,7,7,7,7,7,7
7,7,7,7,7,7,7,7,7,7,7,7,186,7,7,7,127,42,100,7,7,7,7,7,7,7,7,7,7,7,7,7,7,7,7,7,7,7,7,7,7,7,7,7,7,7,7,7,7,7,7,7,7,7,7,7,7,7,7,7,7,7,7,7
7,7,7,7,10,11,7,7,7,7,7,7,7,7,7,127,157,72,7,7,7,7,7,7,7,7,7,7,7,7,7,7,7,7,7,7,7,7,7,7,7,7,7,7,7,7,7,7,7,7,7,7,7,7,7,7,7,7,7,7,7,7,7,7
7,7,7,7,40,41,128,129,129,129,129,129,129,129,127,157,187,102,7,7,7,7,7,7,7,7,7,7,7,7,7,7,7,7,7,7,7,7,7,7,7,7,7,7,7,7,7,7,7,7,7,7,7,7,7,7,7,7,7,7,7,7,7,7
7,7,7,7,7,71,158,159,159,159,159,159,159,159,157,187,217,7,7,7,7,7,7,7,7,7,7,7,7,7,7,7,7,7,7,7,7,7,7,7,7,7,7,7,7,7,7,7,7,7,7,7,7,7,7,7,7,7,7,7,7,7,7,7
7,7,7,7,7,101,188,189,189,189,189,189,189,189,187,217,7,7,7,7,7,7,7,7,7,7,7,7,7,7,7,7,7,7,7,7,7,7,7,7,7,7,7,7,7,7,7,7,7,7,7,7,7,7,7,7,7,7,7,7,7,7,7,7
7,7,7,7,7,7,218,219,219,219,219,219,219,219,217,7,7,7,7,7,7,7,7,7,7,7,7,7,7,7,7,7,7,7,7,7,7,7,7,7,7,7,7,7,7,7,7,7,7,7,7,7,7,7,7,7,7,7,7,7,7,7,7,7
7,7,7,7,7,7,7,7,7,7,7,7,7,7,7,7,7,7,7,7,7,7,7,7,7,7,7,7,7,7,7,7,7,7,7,7,7,7,7,7,7,7,7,7,7,7,7,7,7,7,7,7,7,7,7,7,7,7,7,7,7,7,7,7
7,7,7,7,7,7,7,7,7,7,7,7,7,7,7,7,7,7,7,7,7,7,7,7,7,7,7,7,7,7,7,7,7,7,7,7,7,7,7,7,7,7,7,7,7,7,7,7,7,7,7,7,7,7,7,7,7,7,7,7,7,7,7,7
7,7,7,7,7,7,7,7,7,7,7,7,7,7,7,7,7,7,7,7,7,7,7,7,7,7,7,7,7,7,7,7,7,7,7,7,7,7,7,7,7,7,7,7,7,7,7,7,7,7,7,7,7,7,7,7,7,7,7,7,7,7,7,7
7,7,7,7,7,7,7,7,7,7,7,7,7,7,7,7,7,7,7,7,7,7,7,7,7,7,7,7,7,7,7,7,7,7,7,7,7,7,7,7,7,7,7,7,7,7,7,7,7,7,7,7,7,7,7,7,7,7,7,7,7,7,7,7
7,7,7,7,7,7,7,7,7,7,7,7,7,7,7,7,7,7,7,7,7,7,7,7,7,7,7,7,7,7,7,7,7,7,7,7,7,7,7,7,7,7,7,7,7,7,7,7,7,7,7,7,7,7,7,7,7,7,7,7,7,7,7,7
7,7,7,7,7,7,7,7,7,7,7,7,7,7,7,7,7,7,7,7,7,7,7,7,7,7,7,7,7,7,7,7,7,7,7,7,7,7,7,7,7,7,7,7,7,7,7,7,7,7,7,7,7,7,7,7,7,7,7,7,7,7,7,7
7,7,7,7,7,7,7,7,7,7,7,7,7,7,7,7,7,7,7,7,7,7,7,7,7,7,7,7,7,7,7,7,7,7,7,7,7,7,7,7,7,7,7,7,7,7,7,7,7,7,7,7,7,7,7,7,7,7,7,7,7,7,7,7
7,7,7,7,7,7,7,7,7,7,7,7,7,7,7,7,7,7,7,7,7,7,7,7,7,7,7,7,7,7,7,7,7,7,7,7,7,7,7,7,7,7,7,7,7,7,7,7,7,7,7,7,7,7,7,7,7,7,7,7,7,7,7,7
7,7,7,7,7,7,7,7,7,7,7,7,7,7,7,7,7,7,7,7,7,7,7,7,7,7,7,7,7,7,7,7,7,7,7,7,7,7,7,7,7,7,7,7,7,7,7,7,7,7,7,7,7,7,7,7,7,7,7,7,7,7,7,7

