********************************ll***
****G***************************ll*d*
*************************G******ll***
**********G****G**dd************ll***
********************************ll***
*****G***d*****ddd**************ll*G*
****d************DD******G***G**ll***
*********************d**********ll***
********d**G********G****************
***********************d********s****
**G*****************************s****